111111111111111111111111111111111111111111111111111111111111
1P00000C111111CCC011111CC00111111000000000000000000000000001
111110000000001000000001000000001CCCCC000CCC0000000000000001
1CCC11111000001111100001111100001111100011110000CCCCC0000001
100000000000000001100000001100000001100000010000CCCC00000001
100000001000000001100000001100000001100000C10000CCC000000001
100000001000000001100000001100000001111111110000CC0000000001
100000001000000001111111001111111001000000000000C00000000C01
10000C01111111001C000000000000000010000000000000000CCCCCC001
10000000000000000000000000100000CCCC000000000000000001111111
111111111111111111111111111111111111111111100000000000000001
1C010000000000000000000000000000010000000E100000000000000001
10000110000000000000000000000000000000000C100000000000000001
1000011000000000000C00000111111111111110C1100000000000000001
100001100000000000000000000000000000000000111111100000000001
100001100000000000000000000000001111111110000000000000000001
100001100000000000000000000000000000000000000000100000000001
100001100011000000111000000000000000000000000000100000000001
100001100011000000111000000000000000000000000011100000000001
100001100011000000111000000000000000000000000011100000000001
10000110001100000011100000000000000000000C000011100000000001
100000000011000000111000000C00000011100000C00011100000000001
100000000011000000111000000C000000111000000C0011100000000001
100000000011000000111000000C0000001110000000C011100000000001
1000000000110000C0111000000C00000011100000000C11100000000001
100000000011000000111000000C00000011100000000011000000000001
10000000000C000000000000000C00000011100000000011000000000001
100000000000000000000000000C00000011100000000000000000000001
100000111111110000000000000C00000011100000000000000000000001
1C000000000000000000000000000000001110000CCCCC00000000000011
10000000000000000000000000000000000C0000000000C0000000000111
111111111111111111111111111111111111111111111111111111111111
