1111111111111
11111111C111111
1100P000C000E11
110000000000011
110000110100011
11100000110C111
1111111C1111111
