1111111111111
1001000000001
1CC0011111001
1P0011E0C0001
1111111111111
