111111111111111
1P0000000000001
110000000001E11
100000000000111
110000110100011
111000001100111
111111111111111
