111111111111111
111111111111111
1100P000C000E11
110000000000011
110000110100011
111000001101111
111111111111111
