111111111111111
100000000000001
1100P000C000E11
110000000000011
110000110100011
11100000110C111
111111111111111
