1111111111111
1E010000000C1
1000011111001
1P001100C0001
1111111111111
