11111111111111111111111111111111
1PC000000000001CCCCCCCCCCC1001C1
111111110000101000011111111001C1
1000000000001C00000100000000C1C1
100110000000111111111000111111C1
1CCC10000000CCC0100000001C001CC1
1CCC10000000000C10000000000010C1
111110000111111110000000000010C1
100000000010000000011110000010C1
100001100011001000000C0000000001
100000000011C1100111111110000001
10C110000011001000001CCCC0000001
10C110000000000000001CCCC0000001
10C1100000001000CC001CCCC10000E1
11111111111111111111111111111111
